NO                   ./textures/north.png                   
F 220,100,1
SO ./textures/south.png
C 225,30,99
WE ./textures/west.png
EA ./textures/east.png




111111111111111111111111111111
10000000000000001111100000001
100000000000000000000000000001
100000000000000000000000000001
10000000010000000000000000001
100000000000000000000000000001
111111111110011111111111111111
100000000000000000000000000001
100000000000011111000000000001
100000000000011111111100000101
100000000000000000000011111101
1100000000000000000000000000N1
111111111111111111111111111111


